##########
#........#
#.#......#
#..@.....#
#........#
#........#
##########
